region# lon_min lon_max lat_min lat_max
1       -180.    180.     -90.     -30.
2       -180.    180.     -30.      30.
3       -180.    180.     30.       45.
4       -180.    180.      45.      60.
5       -180.    180.      60.      90.